277583261
277583061
277583017
277582721
277575542
277575533
277574123
277573971
277548984
277445692
277427536
277427501
277427473
277427281
277427225
277427213
277427124
277427115
277427109
277427103
277427101
277427093
277427074
277427069
277427065
277427063
277427055
277427053
277427045
277427043
277427041
277427029
277427023
277427019
277425482
277425480
277425478
277425476
277425474
277425470
277583280
277582782
277575578
277575156
277573766
277573542
277565265
277543486
277534848
277461759
277427747
277427643
277427604
277427592
277427569
277427542
277427519
277427293
277427242
277427169
277427141
277427133
277427127
277427121
277427094
277427087
277427083
277427081
277427070
277427057
277427049
277427047
277427039
277427035
277427033
277427027
277427021
277427017
277425484
277425472
277587960
277583156
277575317
277573696
277573609
277554517
277543644
277543371
277543340
277543329
277461908
277445666
277427727
277427689
277427656
277427138
277427130
277427099
277427085
277427076
277427073
277427067
277427059
277427031
277427025